center_x,center_y,width,height,xmin,ymin,xmax,ymax,top_left_x,top_left_y,top_right_x,top_right_y,bottom_right_x,bottom_right_y,bottom_left_x,bottom_left_y,label,grouplabel,group,text_font,text_style,size_font,filename,path,filename_mask,content
300,400,600,800,0,0,600,800,0,0,600,0,600,800,0,800,document,,,,,,bib_2cols_authors_20211228_152508_7494311762_600_800.png,/scratch/parceirosbr/bigoilict/share/BigOil/document_generator/datasets/documents_2021_12_28/bib_2cols_authors_20211228_152508_7494311762_600_800.png,bib_2cols_authors_20211228_152508_7494311762_600_800_mask.png,
112,4,224,9,70,98,294,107,70,98,294,98,294,107,70,107,sub_line_text,text,text_0,raleway,regular,7,bib_2cols_authors_20211228_152508_7494311762_600_800.png,/scratch/parceirosbr/bigoilict/share/BigOil/document_generator/datasets/documents_2021_12_28/bib_2cols_authors_20211228_152508_7494311762_600_800.png,bib_2cols_authors_20211228_152508_7494311762_600_800_mask.png,"Então  essa  condição  foi  outra,  foram  pequenas  estruturas  de con-"
112,4,225,9,70,109,295,118,70,109,295,109,295,118,70,118,sub_line_text,text,text_0,raleway,regular,7,bib_2cols_authors_20211228_152508_7494311762_600_800.png,/scratch/parceirosbr/bigoilict/share/BigOil/document_generator/datasets/documents_2021_12_28/bib_2cols_authors_20211228_152508_7494311762_600_800.png,bib_2cols_authors_20211228_152508_7494311762_600_800_mask.png,"tenção,   botaram-se  50  ou  60  pequenas  pirâmides  invertidas  para"
112,4,224,9,70,120,294,129,70,120,294,120,294,129,70,129,sub_line_text,text,text_0,raleway,regular,7,bib_2cols_authors_20211228_152508_7494311762_600_800.png,/scratch/parceirosbr/bigoilict/share/BigOil/document_generator/datasets/documents_2021_12_28/bib_2cols_authors_20211228_152508_7494311762_600_800.png,bib_2cols_authors_20211228_152508_7494311762_600_800_mask.png,"segurar   esse   óleo.  Então  é  necessário  encontrar  um  equilíbrio,  e"
112,4,224,9,70,131,294,140,70,131,294,131,294,140,70,140,sub_line_text,text,text_0,raleway,regular,7,bib_2cols_authors_20211228_152508_7494311762_600_800.png,/scratch/parceirosbr/bigoilict/share/BigOil/document_generator/datasets/documents_2021_12_28/bib_2cols_authors_20211228_152508_7494311762_600_800.png,bib_2cols_authors_20211228_152508_7494311762_600_800_mask.png,fazer  verificação  de  convergência  de  malha.  Art.  9  1  Os  serviços
112,4,225,9,70,142,295,151,70,142,295,142,295,151,70,151,sub_line_text,text,text_0,raleway,regular,7,bib_2cols_authors_20211228_152508_7494311762_600_800.png,/scratch/parceirosbr/bigoilict/share/BigOil/document_generator/datasets/documents_2021_12_28/bib_2cols_authors_20211228_152508_7494311762_600_800.png,bib_2cols_authors_20211228_152508_7494311762_600_800_mask.png,"de   transporte,   anteriores   à   data  de  publicação  da  presente  que"
112,4,224,9,70,153,294,162,70,153,294,153,294,162,70,162,sub_line_text,text,text_0,raleway,regular,7,bib_2cols_authors_20211228_152508_7494311762_600_800.png,/scratch/parceirosbr/bigoilict/share/BigOil/document_generator/datasets/documents_2021_12_28/bib_2cols_authors_20211228_152508_7494311762_600_800.png,bib_2cols_authors_20211228_152508_7494311762_600_800_mask.png,"não   estejam   formalizados   em   contratos,   serão  instrumentalizad-"
112,4,225,9,70,164,295,173,70,164,295,164,295,173,70,173,sub_line_text,text,text_0,raleway,regular,7,bib_2cols_authors_20211228_152508_7494311762_600_800.png,/scratch/parceirosbr/bigoilict/share/BigOil/document_generator/datasets/documents_2021_12_28/bib_2cols_authors_20211228_152508_7494311762_600_800.png,bib_2cols_authors_20211228_152508_7494311762_600_800_mask.png,"os  e  os  novos  contratos  remetidos  pelo.  Ou  seja,  consiste em def-"
112,4,224,9,70,175,294,184,70,175,294,175,294,184,70,184,sub_line_text,text,text_0,raleway,regular,7,bib_2cols_authors_20211228_152508_7494311762_600_800.png,/scratch/parceirosbr/bigoilict/share/BigOil/document_generator/datasets/documents_2021_12_28/bib_2cols_authors_20211228_152508_7494311762_600_800.png,bib_2cols_authors_20211228_152508_7494311762_600_800_mask.png,inir  os  limites  externos  do  campo  que  são  responsáveis  pelo  tra-
112,4,224,9,70,186,294,195,70,186,294,186,294,195,70,195,sub_line_text,text,text_0,raleway,regular,7,bib_2cols_authors_20211228_152508_7494311762_600_800.png,/scratch/parceirosbr/bigoilict/share/BigOil/document_generator/datasets/documents_2021_12_28/bib_2cols_authors_20211228_152508_7494311762_600_800.png,bib_2cols_authors_20211228_152508_7494311762_600_800_mask.png,peamento  do  óleo.  Os  resultados  mostraram  que  um grau de supe-
112,4,224,9,70,197,294,206,70,197,294,197,294,206,70,206,sub_line_text,text,text_0,raleway,regular,7,bib_2cols_authors_20211228_152508_7494311762_600_800.png,/scratch/parceirosbr/bigoilict/share/BigOil/document_generator/datasets/documents_2021_12_28/bib_2cols_authors_20211228_152508_7494311762_600_800.png,bib_2cols_authors_20211228_152508_7494311762_600_800_mask.png,"raquecimento  constante  não  afeta  o.  refletem,  cada  uma à sua m-"
103,4,207,9,70,208,277,217,70,208,277,208,277,217,70,217,sub_line_text,text,text_0,raleway,regular,7,bib_2cols_authors_20211228_152508_7494311762_600_800.png,/scratch/parceirosbr/bigoilict/share/BigOil/document_generator/datasets/documents_2021_12_28/bib_2cols_authors_20211228_152508_7494311762_600_800.png,bib_2cols_authors_20211228_152508_7494311762_600_800_mask.png,"aneira, a multiplicidade de usos e visões possíveis desta tecnolo."
112,59,225,119,70,98,295,217,70,98,295,98,295,217,70,217,text,text,text_0,raleway,regular,7,bib_2cols_authors_20211228_152508_7494311762_600_800.png,/scratch/parceirosbr/bigoilict/share/BigOil/document_generator/datasets/documents_2021_12_28/bib_2cols_authors_20211228_152508_7494311762_600_800.png,bib_2cols_authors_20211228_152508_7494311762_600_800_mask.png,nan
37,8,74,17,147,219,221,236,147,219,221,219,221,236,147,236,sub_line_text,title,title_0,raleway,bolditalic,14,bib_2cols_authors_20211228_152508_7494311762_600_800.png,/scratch/parceirosbr/bigoilict/share/BigOil/document_generator/datasets/documents_2021_12_28/bib_2cols_authors_20211228_152508_7494311762_600_800.png,bib_2cols_authors_20211228_152508_7494311762_600_800_mask.png,References
37,8,74,17,147,219,221,236,147,219,221,219,221,236,147,236,title,title,title_0,raleway,bolditalic,14,bib_2cols_authors_20211228_152508_7494311762_600_800.png,/scratch/parceirosbr/bigoilict/share/BigOil/document_generator/datasets/documents_2021_12_28/bib_2cols_authors_20211228_152508_7494311762_600_800.png,bib_2cols_authors_20211228_152508_7494311762_600_800_mask.png,nan
114,191,228,383,70,240,298,623,70,240,298,240,298,623,70,623,list,list,list_1,raleway,raleway,7,bib_2cols_authors_20211228_152508_7494311762_600_800.png,/scratch/parceirosbr/bigoilict/share/BigOil/document_generator/datasets/documents_2021_12_28/bib_2cols_authors_20211228_152508_7494311762_600_800.png,bib_2cols_authors_20211228_152508_7494311762_600_800_mask.png,
112,4,224,9,70,240,294,249,70,240,294,240,294,249,70,249,sub_line_text,list,list_1,raleway,regular,7,bib_2cols_authors_20211228_152508_7494311762_600_800.png,/scratch/parceirosbr/bigoilict/share/BigOil/document_generator/datasets/documents_2021_12_28/bib_2cols_authors_20211228_152508_7494311762_600_800.png,bib_2cols_authors_20211228_152508_7494311762_600_800_mask.png,"[1]   Note-se, assim, que desde março de 1999 não há qualquer tipo de"
83,4,167,9,83,251,250,260,83,251,250,251,250,260,83,260,sub_line_text,list,list_1,raleway,regular,7,bib_2cols_authors_20211228_152508_7494311762_600_800.png,/scratch/parceirosbr/bigoilict/share/BigOil/document_generator/datasets/documents_2021_12_28/bib_2cols_authors_20211228_152508_7494311762_600_800.png,bib_2cols_authors_20211228_152508_7494311762_600_800_mask.png,intervenção governamental na formação dos preços
113,4,227,9,70,262,297,271,70,262,297,262,297,271,70,271,sub_line_text,list,list_1,raleway,regular,7,bib_2cols_authors_20211228_152508_7494311762_600_800.png,/scratch/parceirosbr/bigoilict/share/BigOil/document_generator/datasets/documents_2021_12_28/bib_2cols_authors_20211228_152508_7494311762_600_800.png,bib_2cols_authors_20211228_152508_7494311762_600_800_mask.png,"[35]   Sulphur  presented  variations  in  all  the cores, being the highest"
48,4,97,9,88,273,185,282,88,273,185,273,185,282,88,282,sub_line_text,list,list_1,raleway,regular,7,bib_2cols_authors_20211228_152508_7494311762_600_800.png,/scratch/parceirosbr/bigoilict/share/BigOil/document_generator/datasets/documents_2021_12_28/bib_2cols_authors_20211228_152508_7494311762_600_800.png,bib_2cols_authors_20211228_152508_7494311762_600_800_mask.png,percentages determined in the
101,4,202,9,70,284,272,293,70,284,272,284,272,293,70,293,sub_line_text,list,list_1,raleway,regular,7,bib_2cols_authors_20211228_152508_7494311762_600_800.png,/scratch/parceirosbr/bigoilict/share/BigOil/document_generator/datasets/documents_2021_12_28/bib_2cols_authors_20211228_152508_7494311762_600_800.png,bib_2cols_authors_20211228_152508_7494311762_600_800_mask.png,"[109]   Nesse contexto, a fim de otimizar o processo, as ganham"
42,4,85,9,91,295,176,304,91,295,176,295,176,304,91,304,sub_line_text,list,list_1,raleway,regular,7,bib_2cols_authors_20211228_152508_7494311762_600_800.png,/scratch/parceirosbr/bigoilict/share/BigOil/document_generator/datasets/documents_2021_12_28/bib_2cols_authors_20211228_152508_7494311762_600_800.png,bib_2cols_authors_20211228_152508_7494311762_600_800_mask.png,especial atenção devido à
110,4,220,9,70,306,290,315,70,306,290,306,290,315,70,315,sub_line_text,list,list_1,raleway,regular,7,bib_2cols_authors_20211228_152508_7494311762_600_800.png,/scratch/parceirosbr/bigoilict/share/BigOil/document_generator/datasets/documents_2021_12_28/bib_2cols_authors_20211228_152508_7494311762_600_800.png,bib_2cols_authors_20211228_152508_7494311762_600_800_mask.png,[64]   Estimada através da integração da área sob o pico de desorção
20,4,41,9,88,317,129,326,88,317,129,317,129,326,88,326,sub_line_text,list,list_1,raleway,regular,7,bib_2cols_authors_20211228_152508_7494311762_600_800.png,/scratch/parceirosbr/bigoilict/share/BigOil/document_generator/datasets/documents_2021_12_28/bib_2cols_authors_20211228_152508_7494311762_600_800.png,bib_2cols_authors_20211228_152508_7494311762_600_800_mask.png,de. influence
108,4,217,9,70,328,287,337,70,328,287,328,287,337,70,337,sub_line_text,list,list_1,raleway,regular,7,bib_2cols_authors_20211228_152508_7494311762_600_800.png,/scratch/parceirosbr/bigoilict/share/BigOil/document_generator/datasets/documents_2021_12_28/bib_2cols_authors_20211228_152508_7494311762_600_800.png,bib_2cols_authors_20211228_152508_7494311762_600_800_mask.png,[120]   O filtro é uma técnica de que realiza a implementação de um
35,4,71,9,91,339,162,348,91,339,162,339,162,348,91,348,sub_line_text,list,list_1,raleway,regular,7,bib_2cols_authors_20211228_152508_7494311762_600_800.png,/scratch/parceirosbr/bigoilict/share/BigOil/document_generator/datasets/documents_2021_12_28/bib_2cols_authors_20211228_152508_7494311762_600_800.png,bib_2cols_authors_20211228_152508_7494311762_600_800_mask.png,filtro recursivo através
113,4,227,9,70,350,297,359,70,350,297,350,297,359,70,359,sub_line_text,list,list_1,raleway,regular,7,bib_2cols_authors_20211228_152508_7494311762_600_800.png,/scratch/parceirosbr/bigoilict/share/BigOil/document_generator/datasets/documents_2021_12_28/bib_2cols_authors_20211228_152508_7494311762_600_800.png,bib_2cols_authors_20211228_152508_7494311762_600_800_mask.png,"[119]   Assim, o cede a energia excedente de ao e a energia excedente"
7,4,15,9,90,361,105,370,90,361,105,361,105,370,90,370,sub_line_text,list,list_1,raleway,regular,7,bib_2cols_authors_20211228_152508_7494311762_600_800.png,/scratch/parceirosbr/bigoilict/share/BigOil/document_generator/datasets/documents_2021_12_28/bib_2cols_authors_20211228_152508_7494311762_600_800.png,bib_2cols_authors_20211228_152508_7494311762_600_800_mask.png,de à.
113,4,227,9,70,372,297,381,70,372,297,372,297,381,70,381,sub_line_text,list,list_1,raleway,regular,7,bib_2cols_authors_20211228_152508_7494311762_600_800.png,/scratch/parceirosbr/bigoilict/share/BigOil/document_generator/datasets/documents_2021_12_28/bib_2cols_authors_20211228_152508_7494311762_600_800.png,bib_2cols_authors_20211228_152508_7494311762_600_800_mask.png,"[120]   Que    apresentam   alta   pureza,   utiliza-se   o   onde   algumas"
63,4,127,9,91,383,218,392,91,383,218,383,218,392,91,392,sub_line_text,list,list_1,raleway,regular,7,bib_2cols_authors_20211228_152508_7494311762_600_800.png,/scratch/parceirosbr/bigoilict/share/BigOil/document_generator/datasets/documents_2021_12_28/bib_2cols_authors_20211228_152508_7494311762_600_800.png,bib_2cols_authors_20211228_152508_7494311762_600_800_mask.png,condições operacionais são moderadas.
94,4,188,9,70,394,258,403,70,394,258,394,258,403,70,403,sub_line_text,list,list_1,raleway,regular,7,bib_2cols_authors_20211228_152508_7494311762_600_800.png,/scratch/parceirosbr/bigoilict/share/BigOil/document_generator/datasets/documents_2021_12_28/bib_2cols_authors_20211228_152508_7494311762_600_800.png,bib_2cols_authors_20211228_152508_7494311762_600_800_mask.png,[36]   De agosto de 2013 a julho de 2014 as exportações do
106,4,212,9,70,405,282,414,70,405,282,405,282,414,70,414,sub_line_text,list,list_1,raleway,regular,7,bib_2cols_authors_20211228_152508_7494311762_600_800.png,/scratch/parceirosbr/bigoilict/share/BigOil/document_generator/datasets/documents_2021_12_28/bib_2cols_authors_20211228_152508_7494311762_600_800.png,bib_2cols_authors_20211228_152508_7494311762_600_800_mask.png,[101]   O tem atraído uma larga atenção mundial em função do seu
33,4,66,9,90,416,156,425,90,416,156,416,156,425,90,425,sub_line_text,list,list_1,raleway,regular,7,bib_2cols_authors_20211228_152508_7494311762_600_800.png,/scratch/parceirosbr/bigoilict/share/BigOil/document_generator/datasets/documents_2021_12_28/bib_2cols_authors_20211228_152508_7494311762_600_800.png,bib_2cols_authors_20211228_152508_7494311762_600_800_mask.png,potencial como uma
114,4,228,9,70,427,298,436,70,427,298,427,298,436,70,436,sub_line_text,list,list_1,raleway,regular,7,bib_2cols_authors_20211228_152508_7494311762_600_800.png,/scratch/parceirosbr/bigoilict/share/BigOil/document_generator/datasets/documents_2021_12_28/bib_2cols_authors_20211228_152508_7494311762_600_800.png,bib_2cols_authors_20211228_152508_7494311762_600_800_mask.png,[28]   Os  dados  de  força  foram obtidos pela monitoração da tração de
42,4,84,9,88,438,172,447,88,438,172,438,172,447,88,447,sub_line_text,list,list_1,raleway,regular,7,bib_2cols_authors_20211228_152508_7494311762_600_800.png,/scratch/parceirosbr/bigoilict/share/BigOil/document_generator/datasets/documents_2021_12_28/bib_2cols_authors_20211228_152508_7494311762_600_800.png,bib_2cols_authors_20211228_152508_7494311762_600_800_mask.png,topo. Os autores concluem
98,4,197,9,70,449,267,458,70,449,267,449,267,458,70,458,sub_line_text,list,list_1,raleway,regular,7,bib_2cols_authors_20211228_152508_7494311762_600_800.png,/scratch/parceirosbr/bigoilict/share/BigOil/document_generator/datasets/documents_2021_12_28/bib_2cols_authors_20211228_152508_7494311762_600_800.png,bib_2cols_authors_20211228_152508_7494311762_600_800_mask.png,[33]   Os solventes hidrocarbônicos são frações de petróleo ou
90,4,180,9,88,460,268,469,88,460,268,460,268,469,88,469,sub_line_text,list,list_1,raleway,regular,7,bib_2cols_authors_20211228_152508_7494311762_600_800.png,/scratch/parceirosbr/bigoilict/share/BigOil/document_generator/datasets/documents_2021_12_28/bib_2cols_authors_20211228_152508_7494311762_600_800.png,bib_2cols_authors_20211228_152508_7494311762_600_800_mask.png,"correntes da indústria petroquímica de primeira geração,"
110,4,221,9,70,471,291,480,70,471,291,471,291,480,70,480,sub_line_text,list,list_1,raleway,regular,7,bib_2cols_authors_20211228_152508_7494311762_600_800.png,/scratch/parceirosbr/bigoilict/share/BigOil/document_generator/datasets/documents_2021_12_28/bib_2cols_authors_20211228_152508_7494311762_600_800.png,bib_2cols_authors_20211228_152508_7494311762_600_800_mask.png,[67]   Os pontos em vermelho representamos valores dentro do desvio
64,4,129,9,88,482,217,491,88,482,217,482,217,491,88,491,sub_line_text,list,list_1,raleway,regular,7,bib_2cols_authors_20211228_152508_7494311762_600_800.png,/scratch/parceirosbr/bigoilict/share/BigOil/document_generator/datasets/documents_2021_12_28/bib_2cols_authors_20211228_152508_7494311762_600_800.png,bib_2cols_authors_20211228_152508_7494311762_600_800_mask.png,padrão que superam a eficiêcia de 100%
109,4,218,9,70,493,288,502,70,493,288,493,288,502,70,502,sub_line_text,list,list_1,raleway,regular,7,bib_2cols_authors_20211228_152508_7494311762_600_800.png,/scratch/parceirosbr/bigoilict/share/BigOil/document_generator/datasets/documents_2021_12_28/bib_2cols_authors_20211228_152508_7494311762_600_800.png,bib_2cols_authors_20211228_152508_7494311762_600_800_mask.png,[123]   Nota-se que mesmo para o caso de pior resolução o resultado
54,4,109,9,91,504,200,513,91,504,200,504,200,513,91,513,sub_line_text,list,list_1,raleway,regular,7,bib_2cols_authors_20211228_152508_7494311762_600_800.png,/scratch/parceirosbr/bigoilict/share/BigOil/document_generator/datasets/documents_2021_12_28/bib_2cols_authors_20211228_152508_7494311762_600_800.png,bib_2cols_authors_20211228_152508_7494311762_600_800_mask.png,numérico apresenta concordância
110,4,220,9,70,515,290,524,70,515,290,515,290,524,70,524,sub_line_text,list,list_1,raleway,regular,7,bib_2cols_authors_20211228_152508_7494311762_600_800.png,/scratch/parceirosbr/bigoilict/share/BigOil/document_generator/datasets/documents_2021_12_28/bib_2cols_authors_20211228_152508_7494311762_600_800.png,bib_2cols_authors_20211228_152508_7494311762_600_800_mask.png,[50]   Há uma boa coincidência com o embasamento indicado pelas
55,4,110,9,88,526,198,535,88,526,198,526,198,535,88,535,sub_line_text,list,list_1,raleway,regular,7,bib_2cols_authors_20211228_152508_7494311762_600_800.png,/scratch/parceirosbr/bigoilict/share/BigOil/document_generator/datasets/documents_2021_12_28/bib_2cols_authors_20211228_152508_7494311762_600_800.png,bib_2cols_authors_20211228_152508_7494311762_600_800_mask.png,"isópacas, exceto na parte norte do"
98,4,197,9,70,537,267,546,70,537,267,537,267,546,70,546,sub_line_text,list,list_1,raleway,regular,7,bib_2cols_authors_20211228_152508_7494311762_600_800.png,/scratch/parceirosbr/bigoilict/share/BigOil/document_generator/datasets/documents_2021_12_28/bib_2cols_authors_20211228_152508_7494311762_600_800.png,bib_2cols_authors_20211228_152508_7494311762_600_800_mask.png,[6]   Nos casos onde a formação do hidrato se dá em sistemas
113,4,227,9,70,548,297,557,70,548,297,548,297,557,70,557,sub_line_text,list,list_1,raleway,regular,7,bib_2cols_authors_20211228_152508_7494311762_600_800.png,/scratch/parceirosbr/bigoilict/share/BigOil/document_generator/datasets/documents_2021_12_28/bib_2cols_authors_20211228_152508_7494311762_600_800.png,bib_2cols_authors_20211228_152508_7494311762_600_800_mask.png,[72]   Devido  a  sua configuração trata-se de uma partícula pesada em
43,4,87,9,88,559,175,568,88,559,175,559,175,568,88,568,sub_line_text,list,list_1,raleway,regular,7,bib_2cols_authors_20211228_152508_7494311762_600_800.png,/scratch/parceirosbr/bigoilict/share/BigOil/document_generator/datasets/documents_2021_12_28/bib_2cols_authors_20211228_152508_7494311762_600_800.png,bib_2cols_authors_20211228_152508_7494311762_600_800_mask.png,comparação com o elétron.
114,4,228,9,70,570,298,579,70,570,298,570,298,579,70,579,sub_line_text,list,list_1,raleway,regular,7,bib_2cols_authors_20211228_152508_7494311762_600_800.png,/scratch/parceirosbr/bigoilict/share/BigOil/document_generator/datasets/documents_2021_12_28/bib_2cols_authors_20211228_152508_7494311762_600_800.png,bib_2cols_authors_20211228_152508_7494311762_600_800_mask.png,[9]   A  proteína de cholerae pode formar um dispositivo similar a cauda
10,4,20,9,84,581,104,590,84,581,104,581,104,590,84,590,sub_line_text,list,list_1,raleway,regular,7,bib_2cols_authors_20211228_152508_7494311762_600_800.png,/scratch/parceirosbr/bigoilict/share/BigOil/document_generator/datasets/documents_2021_12_28/bib_2cols_authors_20211228_152508_7494311762_600_800.png,bib_2cols_authors_20211228_152508_7494311762_600_800_mask.png,de um
101,4,202,9,70,592,272,601,70,592,272,592,272,601,70,601,sub_line_text,list,list_1,raleway,regular,7,bib_2cols_authors_20211228_152508_7494311762_600_800.png,/scratch/parceirosbr/bigoilict/share/BigOil/document_generator/datasets/documents_2021_12_28/bib_2cols_authors_20211228_152508_7494311762_600_800.png,bib_2cols_authors_20211228_152508_7494311762_600_800_mask.png,"[107]   Esta nova orientação, embora ainda encontrasse alguma"
61,4,123,9,91,603,214,612,91,603,214,603,214,612,91,612,sub_line_text,list,list_1,raleway,regular,7,bib_2cols_authors_20211228_152508_7494311762_600_800.png,/scratch/parceirosbr/bigoilict/share/BigOil/document_generator/datasets/documents_2021_12_28/bib_2cols_authors_20211228_152508_7494311762_600_800.png,bib_2cols_authors_20211228_152508_7494311762_600_800_mask.png,oposição no plenário do refletia o forte
110,4,221,9,70,614,291,623,70,614,291,614,291,623,70,623,sub_line_text,list,list_1,raleway,regular,7,bib_2cols_authors_20211228_152508_7494311762_600_800.png,/scratch/parceirosbr/bigoilict/share/BigOil/document_generator/datasets/documents_2021_12_28/bib_2cols_authors_20211228_152508_7494311762_600_800.png,bib_2cols_authors_20211228_152508_7494311762_600_800_mask.png,"[38]   As falhas afetam os diques de rochas básicas, denunciando sua"
113,32,227,64,322,98,549,162,322,98,549,98,549,162,322,162,list,list,list_2,raleway,raleway,7,bib_2cols_authors_20211228_152508_7494311762_600_800.png,/scratch/parceirosbr/bigoilict/share/BigOil/document_generator/datasets/documents_2021_12_28/bib_2cols_authors_20211228_152508_7494311762_600_800.png,bib_2cols_authors_20211228_152508_7494311762_600_800_mask.png,
99,4,198,9,322,98,520,107,322,98,520,98,520,107,322,107,sub_line_text,list,list_2,raleway,regular,7,bib_2cols_authors_20211228_152508_7494311762_600_800.png,/scratch/parceirosbr/bigoilict/share/BigOil/document_generator/datasets/documents_2021_12_28/bib_2cols_authors_20211228_152508_7494311762_600_800.png,bib_2cols_authors_20211228_152508_7494311762_600_800_mask.png,[128]   Esta seção apresenta os resultados da 10 de para e de e
16,4,33,9,343,109,376,118,343,109,376,109,376,118,343,118,sub_line_text,list,list_2,raleway,regular,7,bib_2cols_authors_20211228_152508_7494311762_600_800.png,/scratch/parceirosbr/bigoilict/share/BigOil/document_generator/datasets/documents_2021_12_28/bib_2cols_authors_20211228_152508_7494311762_600_800.png,bib_2cols_authors_20211228_152508_7494311762_600_800_mask.png,realizadas
113,4,226,9,322,120,548,129,322,120,548,120,548,129,322,129,sub_line_text,list,list_2,raleway,regular,7,bib_2cols_authors_20211228_152508_7494311762_600_800.png,/scratch/parceirosbr/bigoilict/share/BigOil/document_generator/datasets/documents_2021_12_28/bib_2cols_authors_20211228_152508_7494311762_600_800.png,bib_2cols_authors_20211228_152508_7494311762_600_800_mask.png,"[59]   Além das três categorias de premiação, haverá um prêmio para a"
113,4,227,9,322,131,549,140,322,131,549,131,549,140,322,140,sub_line_text,list,list_2,raleway,regular,7,bib_2cols_authors_20211228_152508_7494311762_600_800.png,/scratch/parceirosbr/bigoilict/share/BigOil/document_generator/datasets/documents_2021_12_28/bib_2cols_authors_20211228_152508_7494311762_600_800.png,bib_2cols_authors_20211228_152508_7494311762_600_800_mask.png,[36]   Esses  derramamentos  acontecem  em razão de falhas estruturais
81,4,162,9,340,142,502,151,340,142,502,142,502,151,340,151,sub_line_text,list,list_2,raleway,regular,7,bib_2cols_authors_20211228_152508_7494311762_600_800.png,/scratch/parceirosbr/bigoilict/share/BigOil/document_generator/datasets/documents_2021_12_28/bib_2cols_authors_20211228_152508_7494311762_600_800.png,bib_2cols_authors_20211228_152508_7494311762_600_800_mask.png,"dos equipamentos, falhas humanas na execução e"
113,4,227,9,322,153,549,162,322,153,549,153,549,162,322,162,sub_line_text,list,list_2,raleway,regular,7,bib_2cols_authors_20211228_152508_7494311762_600_800.png,/scratch/parceirosbr/bigoilict/share/BigOil/document_generator/datasets/documents_2021_12_28/bib_2cols_authors_20211228_152508_7494311762_600_800.png,bib_2cols_authors_20211228_152508_7494311762_600_800_mask.png,"[128]   Os testes foram realizados em agitador magnético, com agitação"
41,44,83,88,335,170,418,258,335,170,418,170,418,258,335,258,image,figure_image,figure_0,,,,bib_2cols_authors_20211228_152508_7494311762_600_800.png,/scratch/parceirosbr/bigoilict/share/BigOil/document_generator/datasets/documents_2021_12_28/bib_2cols_authors_20211228_152508_7494311762_600_800.png,bib_2cols_authors_20211228_152508_7494311762_600_800_mask.png,/scratch/parceirosbr/bigoilict/share/BigOil/document_generator/files_images_document_generator/faces\Adriana Lima15_52.jpg
53,4,106,9,439,170,545,179,439,170,545,170,545,179,439,179,sub_line_text,text,text_1,raleway,regular,7,bib_2cols_authors_20211228_152508_7494311762_600_800.png,/scratch/parceirosbr/bigoilict/share/BigOil/document_generator/datasets/documents_2021_12_28/bib_2cols_authors_20211228_152508_7494311762_600_800.png,bib_2cols_authors_20211228_152508_7494311762_600_800_mask.png,Os   autores   reportaram  que  di-
53,4,107,9,439,181,546,190,439,181,546,181,546,190,439,190,sub_line_text,text,text_1,raleway,regular,7,bib_2cols_authors_20211228_152508_7494311762_600_800.png,/scratch/parceirosbr/bigoilict/share/BigOil/document_generator/datasets/documents_2021_12_28/bib_2cols_authors_20211228_152508_7494311762_600_800.png,bib_2cols_authors_20211228_152508_7494311762_600_800_mask.png,minuindo   a  pressão  e  aument-
53,4,107,9,439,192,546,201,439,192,546,192,546,201,439,201,sub_line_text,text,text_1,raleway,regular,7,bib_2cols_authors_20211228_152508_7494311762_600_800.png,/scratch/parceirosbr/bigoilict/share/BigOil/document_generator/datasets/documents_2021_12_28/bib_2cols_authors_20211228_152508_7494311762_600_800.png,bib_2cols_authors_20211228_152508_7494311762_600_800_mask.png,"ando  o  fluxo  de entrada, aume-"
53,4,106,9,439,203,545,212,439,203,545,203,545,212,439,212,sub_line_text,text,text_1,raleway,regular,7,bib_2cols_authors_20211228_152508_7494311762_600_800.png,/scratch/parceirosbr/bigoilict/share/BigOil/document_generator/datasets/documents_2021_12_28/bib_2cols_authors_20211228_152508_7494311762_600_800.png,bib_2cols_authors_20211228_152508_7494311762_600_800_mask.png,ntou  a  remoção de e diminuiu a
53,4,106,9,439,214,545,223,439,214,545,214,545,223,439,223,sub_line_text,text,text_1,raleway,regular,7,bib_2cols_authors_20211228_152508_7494311762_600_800.png,/scratch/parceirosbr/bigoilict/share/BigOil/document_generator/datasets/documents_2021_12_28/bib_2cols_authors_20211228_152508_7494311762_600_800.png,bib_2cols_authors_20211228_152508_7494311762_600_800_mask.png,turbidez   do  efluente.  Ao  anali-
53,4,107,9,439,225,546,234,439,225,546,225,546,234,439,234,sub_line_text,text,text_1,raleway,regular,7,bib_2cols_authors_20211228_152508_7494311762_600_800.png,/scratch/parceirosbr/bigoilict/share/BigOil/document_generator/datasets/documents_2021_12_28/bib_2cols_authors_20211228_152508_7494311762_600_800.png,bib_2cols_authors_20211228_152508_7494311762_600_800_mask.png,"sar   esses   efeitos,   foram   dest-"
53,4,106,9,439,236,545,245,439,236,545,236,545,245,439,245,sub_line_text,text,text_1,raleway,regular,7,bib_2cols_authors_20211228_152508_7494311762_600_800.png,/scratch/parceirosbr/bigoilict/share/BigOil/document_generator/datasets/documents_2021_12_28/bib_2cols_authors_20211228_152508_7494311762_600_800.png,bib_2cols_authors_20211228_152508_7494311762_600_800_mask.png,acados  não  apenas  a alteração
53,4,107,9,439,247,546,256,439,247,546,247,546,256,439,256,sub_line_text,text,text_1,raleway,regular,7,bib_2cols_authors_20211228_152508_7494311762_600_800.png,/scratch/parceirosbr/bigoilict/share/BigOil/document_generator/datasets/documents_2021_12_28/bib_2cols_authors_20211228_152508_7494311762_600_800.png,bib_2cols_authors_20211228_152508_7494311762_600_800_mask.png,nos   preços   relativos  dos  com-
48,4,97,9,439,258,536,267,439,258,536,258,536,267,439,267,sub_line_text,text,text_1,raleway,regular,7,bib_2cols_authors_20211228_152508_7494311762_600_800.png,/scratch/parceirosbr/bigoilict/share/BigOil/document_generator/datasets/documents_2021_12_28/bib_2cols_authors_20211228_152508_7494311762_600_800.png,bib_2cols_authors_20211228_152508_7494311762_600_800_mask.png,"bustíveis, que gera sinais para."
53,48,107,97,439,170,546,267,439,170,546,170,546,267,439,267,text,text,text_1,raleway,regular,7,bib_2cols_authors_20211228_152508_7494311762_600_800.png,/scratch/parceirosbr/bigoilict/share/BigOil/document_generator/datasets/documents_2021_12_28/bib_2cols_authors_20211228_152508_7494311762_600_800.png,bib_2cols_authors_20211228_152508_7494311762_600_800_mask.png,nan
38,40,76,81,339,273,415,354,339,273,415,273,415,354,339,354,image,figure_image,figure_3,,,,bib_2cols_authors_20211228_152508_7494311762_600_800.png,/scratch/parceirosbr/bigoilict/share/BigOil/document_generator/datasets/documents_2021_12_28/bib_2cols_authors_20211228_152508_7494311762_600_800.png,bib_2cols_authors_20211228_152508_7494311762_600_800_mask.png,/scratch/parceirosbr/bigoilict/share/BigOil/document_generator/files_images_document_generator/faces\Zoe Saldana16_4922.jpg
53,4,106,9,439,273,545,282,439,273,545,273,545,282,439,282,sub_line_text,text,text_2,raleway,regular,7,bib_2cols_authors_20211228_152508_7494311762_600_800.png,/scratch/parceirosbr/bigoilict/share/BigOil/document_generator/datasets/documents_2021_12_28/bib_2cols_authors_20211228_152508_7494311762_600_800.png,bib_2cols_authors_20211228_152508_7494311762_600_800_mask.png,Para   prever   respostas   máxim-
53,4,107,9,439,284,546,293,439,284,546,284,546,293,439,293,sub_line_text,text,text_2,raleway,regular,7,bib_2cols_authors_20211228_152508_7494311762_600_800.png,/scratch/parceirosbr/bigoilict/share/BigOil/document_generator/datasets/documents_2021_12_28/bib_2cols_authors_20211228_152508_7494311762_600_800.png,bib_2cols_authors_20211228_152508_7494311762_600_800_mask.png,"as,  um  espectro  de  mar  de  te-"
53,4,107,9,439,295,546,304,439,295,546,295,546,304,439,304,sub_line_text,text,text_2,raleway,regular,7,bib_2cols_authors_20211228_152508_7494311762_600_800.png,/scratch/parceirosbr/bigoilict/share/BigOil/document_generator/datasets/documents_2021_12_28/bib_2cols_authors_20211228_152508_7494311762_600_800.png,bib_2cols_authors_20211228_152508_7494311762_600_800_mask.png,mpestade  extrema  deve  ser  ut-
53,4,107,9,439,306,546,315,439,306,546,306,546,315,439,315,sub_line_text,text,text_2,raleway,regular,7,bib_2cols_authors_20211228_152508_7494311762_600_800.png,/scratch/parceirosbr/bigoilict/share/BigOil/document_generator/datasets/documents_2021_12_28/bib_2cols_authors_20211228_152508_7494311762_600_800.png,bib_2cols_authors_20211228_152508_7494311762_600_800_mask.png,ilizado.   Quando  induzida  por  t-
53,4,107,9,439,317,546,326,439,317,546,317,546,326,439,326,sub_line_text,text,text_2,raleway,regular,7,bib_2cols_authors_20211228_152508_7494311762_600_800.png,/scratch/parceirosbr/bigoilict/share/BigOil/document_generator/datasets/documents_2021_12_28/bib_2cols_authors_20211228_152508_7494311762_600_800.png,bib_2cols_authors_20211228_152508_7494311762_600_800_mask.png,"emperatura,   obtém-se  uma  va-"
53,4,107,9,439,328,546,337,439,328,546,328,546,337,439,337,sub_line_text,text,text_2,raleway,regular,7,bib_2cols_authors_20211228_152508_7494311762_600_800.png,/scratch/parceirosbr/bigoilict/share/BigOil/document_generator/datasets/documents_2021_12_28/bib_2cols_authors_20211228_152508_7494311762_600_800.png,bib_2cols_authors_20211228_152508_7494311762_600_800_mask.png,riante    de   martensita   maclada
53,4,107,9,439,339,546,348,439,339,546,339,546,348,439,348,sub_line_text,text,text_2,raleway,regular,7,bib_2cols_authors_20211228_152508_7494311762_600_800.png,/scratch/parceirosbr/bigoilict/share/BigOil/document_generator/datasets/documents_2021_12_28/bib_2cols_authors_20211228_152508_7494311762_600_800.png,bib_2cols_authors_20211228_152508_7494311762_600_800_mask.png,com    estrutura   cristalina   ortor-
53,4,107,9,439,350,546,359,439,350,546,350,546,359,439,359,sub_line_text,text,text_2,raleway,regular,7,bib_2cols_authors_20211228_152508_7494311762_600_800.png,/scratch/parceirosbr/bigoilict/share/BigOil/document_generator/datasets/documents_2021_12_28/bib_2cols_authors_20211228_152508_7494311762_600_800.png,bib_2cols_authors_20211228_152508_7494311762_600_800_mask.png,rômbica.    Dentre   as   principais
53,4,107,9,439,361,546,370,439,361,546,361,546,370,439,370,sub_line_text,text,text_2,raleway,regular,7,bib_2cols_authors_20211228_152508_7494311762_600_800.png,/scratch/parceirosbr/bigoilict/share/BigOil/document_generator/datasets/documents_2021_12_28/bib_2cols_authors_20211228_152508_7494311762_600_800.png,bib_2cols_authors_20211228_152508_7494311762_600_800_mask.png,"contribuições,    destacam-se   d-"
53,4,106,9,439,372,545,381,439,372,545,372,545,381,439,381,sub_line_text,text,text_2,raleway,regular,7,bib_2cols_authors_20211228_152508_7494311762_600_800.png,/scratch/parceirosbr/bigoilict/share/BigOil/document_generator/datasets/documents_2021_12_28/bib_2cols_authors_20211228_152508_7494311762_600_800.png,bib_2cols_authors_20211228_152508_7494311762_600_800_mask.png,esde   investigações   voltadas  a
53,4,106,9,439,383,545,392,439,383,545,383,545,392,439,392,sub_line_text,text,text_2,raleway,regular,7,bib_2cols_authors_20211228_152508_7494311762_600_800.png,/scratch/parceirosbr/bigoilict/share/BigOil/document_generator/datasets/documents_2021_12_28/bib_2cols_authors_20211228_152508_7494311762_600_800.png,bib_2cols_authors_20211228_152508_7494311762_600_800_mask.png,aspectos   relacionados   à  parti-
47,4,94,9,439,394,533,403,439,394,533,394,533,403,439,403,sub_line_text,text,text_2,raleway,regular,7,bib_2cols_authors_20211228_152508_7494311762_600_800.png,/scratch/parceirosbr/bigoilict/share/BigOil/document_generator/datasets/documents_2021_12_28/bib_2cols_authors_20211228_152508_7494311762_600_800.png,bib_2cols_authors_20211228_152508_7494311762_600_800_mask.png,cipação de empresas estrang.
53,65,107,130,439,273,546,403,439,273,546,273,546,403,439,403,text,text,text_2,raleway,regular,7,bib_2cols_authors_20211228_152508_7494311762_600_800.png,/scratch/parceirosbr/bigoilict/share/BigOil/document_generator/datasets/documents_2021_12_28/bib_2cols_authors_20211228_152508_7494311762_600_800.png,bib_2cols_authors_20211228_152508_7494311762_600_800_mask.png,nan
32,34,64,68,345,409,409,477,345,409,409,409,409,477,345,477,image,figure_image,figure_5,,,,bib_2cols_authors_20211228_152508_7494311762_600_800.png,/scratch/parceirosbr/bigoilict/share/BigOil/document_generator/datasets/documents_2021_12_28/bib_2cols_authors_20211228_152508_7494311762_600_800.png,bib_2cols_authors_20211228_152508_7494311762_600_800_mask.png,/scratch/parceirosbr/bigoilict/share/BigOil/document_generator/files_images_document_generator/faces\Eliza Taylor55_835.jpg
53,4,107,9,439,409,546,418,439,409,546,409,546,418,439,418,sub_line_text,text,text_3,raleway,regular,7,bib_2cols_authors_20211228_152508_7494311762_600_800.png,/scratch/parceirosbr/bigoilict/share/BigOil/document_generator/datasets/documents_2021_12_28/bib_2cols_authors_20211228_152508_7494311762_600_800.png,bib_2cols_authors_20211228_152508_7494311762_600_800_mask.png,A  do  tem  a segunda maior cap-
53,4,106,9,439,420,545,429,439,420,545,420,545,429,439,429,sub_line_text,text,text_3,raleway,regular,7,bib_2cols_authors_20211228_152508_7494311762_600_800.png,/scratch/parceirosbr/bigoilict/share/BigOil/document_generator/datasets/documents_2021_12_28/bib_2cols_authors_20211228_152508_7494311762_600_800.png,bib_2cols_authors_20211228_152508_7494311762_600_800_mask.png,acidade  de  destilação de petró-
53,4,107,9,439,431,546,440,439,431,546,431,546,440,439,440,sub_line_text,text,text_3,raleway,regular,7,bib_2cols_authors_20211228_152508_7494311762_600_800.png,/scratch/parceirosbr/bigoilict/share/BigOil/document_generator/datasets/documents_2021_12_28/bib_2cols_authors_20211228_152508_7494311762_600_800.png,bib_2cols_authors_20211228_152508_7494311762_600_800_mask.png,"leo  da  (485  mil  bpd), sendo su-"
53,4,107,9,439,442,546,451,439,442,546,442,546,451,439,451,sub_line_text,text,text_3,raleway,regular,7,bib_2cols_authors_20211228_152508_7494311762_600_800.png,/scratch/parceirosbr/bigoilict/share/BigOil/document_generator/datasets/documents_2021_12_28/bib_2cols_authors_20211228_152508_7494311762_600_800.png,bib_2cols_authors_20211228_152508_7494311762_600_800_mask.png,perada  apenas  pela  do (726 mil
53,4,107,9,439,453,546,462,439,453,546,453,546,462,439,462,sub_line_text,text,text_3,raleway,regular,7,bib_2cols_authors_20211228_152508_7494311762_600_800.png,/scratch/parceirosbr/bigoilict/share/BigOil/document_generator/datasets/documents_2021_12_28/bib_2cols_authors_20211228_152508_7494311762_600_800.png,bib_2cols_authors_20211228_152508_7494311762_600_800_mask.png,bpd)  2014  apud  2014). O 3 final-
53,4,106,9,439,464,545,473,439,464,545,464,545,473,439,473,sub_line_text,text,text_3,raleway,regular,7,bib_2cols_authors_20211228_152508_7494311762_600_800.png,/scratch/parceirosbr/bigoilict/share/BigOil/document_generator/datasets/documents_2021_12_28/bib_2cols_authors_20211228_152508_7494311762_600_800.png,bib_2cols_authors_20211228_152508_7494311762_600_800_mask.png,iza  com  um  breve  histórico  da
48,4,97,9,439,475,536,484,439,475,536,475,536,484,439,484,sub_line_text,text,text_3,raleway,regular,7,bib_2cols_authors_20211228_152508_7494311762_600_800.png,/scratch/parceirosbr/bigoilict/share/BigOil/document_generator/datasets/documents_2021_12_28/bib_2cols_authors_20211228_152508_7494311762_600_800.png,bib_2cols_authors_20211228_152508_7494311762_600_800_mask.png,visualização científica que foi.
53,37,107,75,439,409,546,484,439,409,546,409,546,484,439,484,text,text,text_3,raleway,regular,7,bib_2cols_authors_20211228_152508_7494311762_600_800.png,/scratch/parceirosbr/bigoilict/share/BigOil/document_generator/datasets/documents_2021_12_28/bib_2cols_authors_20211228_152508_7494311762_600_800.png,bib_2cols_authors_20211228_152508_7494311762_600_800_mask.png,nan
34,37,69,74,342,490,411,564,342,490,411,490,411,564,342,564,image,figure_image,figure_7,,,,bib_2cols_authors_20211228_152508_7494311762_600_800.png,/scratch/parceirosbr/bigoilict/share/BigOil/document_generator/datasets/documents_2021_12_28/bib_2cols_authors_20211228_152508_7494311762_600_800.png,bib_2cols_authors_20211228_152508_7494311762_600_800_mask.png,/scratch/parceirosbr/bigoilict/share/BigOil/document_generator/files_images_document_generator/faces\Danielle Panabaker2_1460.jpg
53,4,106,9,439,490,545,499,439,490,545,490,545,499,439,499,sub_line_text,text,text_4,raleway,regular,7,bib_2cols_authors_20211228_152508_7494311762_600_800.png,/scratch/parceirosbr/bigoilict/share/BigOil/document_generator/datasets/documents_2021_12_28/bib_2cols_authors_20211228_152508_7494311762_600_800.png,bib_2cols_authors_20211228_152508_7494311762_600_800_mask.png,A   rede   de   transporte  operada
53,4,107,9,439,501,546,510,439,501,546,501,546,510,439,510,sub_line_text,text,text_4,raleway,regular,7,bib_2cols_authors_20211228_152508_7494311762_600_800.png,/scratch/parceirosbr/bigoilict/share/BigOil/document_generator/datasets/documents_2021_12_28/bib_2cols_authors_20211228_152508_7494311762_600_800.png,bib_2cols_authors_20211228_152508_7494311762_600_800_mask.png,pela  (antiga  é  composta  por  s-
53,4,106,9,439,512,545,521,439,512,545,512,545,521,439,521,sub_line_text,text,text_4,raleway,regular,7,bib_2cols_authors_20211228_152508_7494311762_600_800.png,/scratch/parceirosbr/bigoilict/share/BigOil/document_generator/datasets/documents_2021_12_28/bib_2cols_authors_20211228_152508_7494311762_600_800.png,bib_2cols_authors_20211228_152508_7494311762_600_800_mask.png,ete  terminais  de  recepção  lito-
53,4,106,9,439,523,545,532,439,523,545,523,545,532,439,532,sub_line_text,text,text_4,raleway,regular,7,bib_2cols_authors_20211228_152508_7494311762_600_800.png,/scratch/parceirosbr/bigoilict/share/BigOil/document_generator/datasets/documents_2021_12_28/bib_2cols_authors_20211228_152508_7494311762_600_800.png,bib_2cols_authors_20211228_152508_7494311762_600_800_mask.png,"râneos   (beach  terminals),  6600"
53,4,106,9,439,534,545,543,439,534,545,534,545,543,439,543,sub_line_text,text,text_4,raleway,regular,7,bib_2cols_authors_20211228_152508_7494311762_600_800.png,/scratch/parceirosbr/bigoilict/share/BigOil/document_generator/datasets/documents_2021_12_28/bib_2cols_authors_20211228_152508_7494311762_600_800.png,bib_2cols_authors_20211228_152508_7494311762_600_800_mask.png,km  de  gasodutos  de  alta  pres-
53,4,107,9,439,545,546,554,439,545,546,545,546,554,439,554,sub_line_text,text,text_4,raleway,regular,7,bib_2cols_authors_20211228_152508_7494311762_600_800.png,/scratch/parceirosbr/bigoilict/share/BigOil/document_generator/datasets/documents_2021_12_28/bib_2cols_authors_20211228_152508_7494311762_600_800.png,bib_2cols_authors_20211228_152508_7494311762_600_800_mask.png,são  (National  de  um  total de 2-
53,4,107,9,439,556,546,565,439,556,546,556,546,565,439,565,sub_line_text,text,text_4,raleway,regular,7,bib_2cols_authors_20211228_152508_7494311762_600_800.png,/scratch/parceirosbr/bigoilict/share/BigOil/document_generator/datasets/documents_2021_12_28/bib_2cols_authors_20211228_152508_7494311762_600_800.png,bib_2cols_authors_20211228_152508_7494311762_600_800_mask.png,"75  mil  km,  e  mais de 140 pont-"
22,4,44,9,439,567,483,576,439,567,483,567,483,576,439,576,sub_line_text,text,text_4,raleway,regular,7,bib_2cols_authors_20211228_152508_7494311762_600_800.png,/scratch/parceirosbr/bigoilict/share/BigOil/document_generator/datasets/documents_2021_12_28/bib_2cols_authors_20211228_152508_7494311762_600_800.png,bib_2cols_authors_20211228_152508_7494311762_600_800_mask.png,os de retirada.
53,43,107,86,439,490,546,576,439,490,546,490,546,576,439,576,text,text,text_4,raleway,regular,7,bib_2cols_authors_20211228_152508_7494311762_600_800.png,/scratch/parceirosbr/bigoilict/share/BigOil/document_generator/datasets/documents_2021_12_28/bib_2cols_authors_20211228_152508_7494311762_600_800.png,bib_2cols_authors_20211228_152508_7494311762_600_800_mask.png,nan
28,30,57,61,348,582,405,643,348,582,405,582,405,643,348,643,image,figure_image,figure_9,,,,bib_2cols_authors_20211228_152508_7494311762_600_800.png,/scratch/parceirosbr/bigoilict/share/BigOil/document_generator/datasets/documents_2021_12_28/bib_2cols_authors_20211228_152508_7494311762_600_800.png,bib_2cols_authors_20211228_152508_7494311762_600_800_mask.png,/scratch/parceirosbr/bigoilict/share/BigOil/document_generator/files_images_document_generator/faces\Elizabeth Lail12_1071.jpg
53,4,106,9,439,582,545,591,439,582,545,582,545,591,439,591,sub_line_text,text,text_5,raleway,regular,7,bib_2cols_authors_20211228_152508_7494311762_600_800.png,/scratch/parceirosbr/bigoilict/share/BigOil/document_generator/datasets/documents_2021_12_28/bib_2cols_authors_20211228_152508_7494311762_600_800.png,bib_2cols_authors_20211228_152508_7494311762_600_800_mask.png,Para   gerar  valores  de  saída  s-
53,4,107,9,439,593,546,602,439,593,546,593,546,602,439,602,sub_line_text,text,text_5,raleway,regular,7,bib_2cols_authors_20211228_152508_7494311762_600_800.png,/scratch/parceirosbr/bigoilict/share/BigOil/document_generator/datasets/documents_2021_12_28/bib_2cols_authors_20211228_152508_7494311762_600_800.png,bib_2cols_authors_20211228_152508_7494311762_600_800_mask.png,"ão  usados  dados  de um de que,"
53,4,107,9,439,604,546,613,439,604,546,604,546,613,439,613,sub_line_text,text,text_5,raleway,regular,7,bib_2cols_authors_20211228_152508_7494311762_600_800.png,/scratch/parceirosbr/bigoilict/share/BigOil/document_generator/datasets/documents_2021_12_28/bib_2cols_authors_20211228_152508_7494311762_600_800.png,bib_2cols_authors_20211228_152508_7494311762_600_800_mask.png,juntamente  com  a  de formam o
53,4,107,9,439,615,546,624,439,615,546,615,546,624,439,624,sub_line_text,text,text_5,raleway,regular,7,bib_2cols_authors_20211228_152508_7494311762_600_800.png,/scratch/parceirosbr/bigoilict/share/BigOil/document_generator/datasets/documents_2021_12_28/bib_2cols_authors_20211228_152508_7494311762_600_800.png,bib_2cols_authors_20211228_152508_7494311762_600_800_mask.png,sobre   o   sistema.   Temos  então
53,4,106,9,439,626,545,635,439,626,545,626,545,635,439,635,sub_line_text,text,text_5,raleway,regular,7,bib_2cols_authors_20211228_152508_7494311762_600_800.png,/scratch/parceirosbr/bigoilict/share/BigOil/document_generator/datasets/documents_2021_12_28/bib_2cols_authors_20211228_152508_7494311762_600_800.png,bib_2cols_authors_20211228_152508_7494311762_600_800_mask.png,que   oespaço  e  basicamente  o
53,4,107,9,439,637,546,646,439,637,546,637,546,646,439,646,sub_line_text,text,text_5,raleway,regular,7,bib_2cols_authors_20211228_152508_7494311762_600_800.png,/scratch/parceirosbr/bigoilict/share/BigOil/document_generator/datasets/documents_2021_12_28/bib_2cols_authors_20211228_152508_7494311762_600_800.png,bib_2cols_authors_20211228_152508_7494311762_600_800_mask.png,auto-dual  de  levando em consi-
53,4,107,9,439,648,546,657,439,648,546,648,546,657,439,657,sub_line_text,text,text_5,raleway,regular,7,bib_2cols_authors_20211228_152508_7494311762_600_800.png,/scratch/parceirosbr/bigoilict/share/BigOil/document_generator/datasets/documents_2021_12_28/bib_2cols_authors_20211228_152508_7494311762_600_800.png,bib_2cols_authors_20211228_152508_7494311762_600_800_mask.png,deração  a  seguinte  relação:1p+-
53,4,107,9,439,659,546,668,439,659,546,659,546,668,439,668,sub_line_text,text,text_5,raleway,regular,7,bib_2cols_authors_20211228_152508_7494311762_600_800.png,/scratch/parceirosbr/bigoilict/share/BigOil/document_generator/datasets/documents_2021_12_28/bib_2cols_authors_20211228_152508_7494311762_600_800.png,bib_2cols_authors_20211228_152508_7494311762_600_800_mask.png,1q.  Quase  todo  o  gás  natural  é
53,4,107,9,439,670,546,679,439,670,546,670,546,679,439,679,sub_line_text,text,text_5,raleway,regular,7,bib_2cols_authors_20211228_152508_7494311762_600_800.png,/scratch/parceirosbr/bigoilict/share/BigOil/document_generator/datasets/documents_2021_12_28/bib_2cols_authors_20211228_152508_7494311762_600_800.png,bib_2cols_authors_20211228_152508_7494311762_600_800_mask.png,utilizado   para   geração  elétrica
48,4,96,9,439,681,535,690,439,681,535,681,535,690,439,690,sub_line_text,text,text_5,raleway,regular,7,bib_2cols_authors_20211228_152508_7494311762_600_800.png,/scratch/parceirosbr/bigoilict/share/BigOil/document_generator/datasets/documents_2021_12_28/bib_2cols_authors_20211228_152508_7494311762_600_800.png,bib_2cols_authors_20211228_152508_7494311762_600_800_mask.png,ou como matéria-prima em pl.
53,54,107,108,439,582,546,690,439,582,546,582,546,690,439,690,text,text,text_5,raleway,regular,7,bib_2cols_authors_20211228_152508_7494311762_600_800.png,/scratch/parceirosbr/bigoilict/share/BigOil/document_generator/datasets/documents_2021_12_28/bib_2cols_authors_20211228_152508_7494311762_600_800.png,bib_2cols_authors_20211228_152508_7494311762_600_800_mask.png,nan
